00000000110000000000000
00000000110000000000000
00000000110000000000000
00000100110000000000000
00000000000000000000000
01110000000000000000111
00000000000000000000000
01111111111111110000000